20
    + + + + + + + + + + + + + + + +    
    +             +               +    
. . . . . . .     +       . . . . . . .
. . . . . . .     +       . . . . . . .
. . . . @ . .     +       . * . . . . #
. R . . . . .     +       . . . . . . .
. . . . . . .     +       . . . . . . .
. . . . . . . + + +       . . . . . . .
. . . . . . .                 +        
. . . * . . .                 +        
. . . . . . .                 +        
. . . . . . .                 +        
. . . . . . .                 +        
        +                     +        
        +           . . . .   +        
        +           . . . .   +        
        + + + + + + . . * . + +        
                    . . . .            
                    . $ . .            
                    . . . .             