20
+ + + + + + + + + + + + + + + + + + + +
+         +               +           +
+         +               +           +
+         +               +           +
+     . . . . .       . . . . .       +
+     . * . . .       . . . . .       +
+ + + . . R . . + + + . . . * . + + + #
+     . . . . .       . $ . . .       +
+     . . . . .       . . . . .       +
+         +               +           +
+         +               +           +
+         +               +           +
+     . . . . .       . . . . .       +
+     . . * . .       . . . . .       +
+ + + . . . . . + + + . . * . . + + + +
+     . . . . .       . . . . .       +
+     . . . . .       . . . . @       +
+         +               +           +
+         +               +           +
+ + + + + + + + + + + + + + + + + + + + 