20
. . . . . . . + + + + + + + + + + . . .
. . . . . . .                   . . . .
. @ . . . . .             . . . . . . .
. . . . . . .             . . . . . . .
. . . . . . .             . . . . . . .
. . . . . . .             . . * . . . .
. . . . . . .             . . . . . . .
. . . * . . M + + + + + + . . . . . . .
. . . . . . .                 . .     +
. . . . . . .                 . .     +
. . . . . . .                 . .     +
. . . . . . .                 . .     +
. . . . . . .                 . . + + +
    . . .                     . .      
    . . .                     . .      
    . . .                     . .      
    . . . + + + + + + + + + + . *      
    . . .                     . .      
    . . .                     . .      
    . . . . . . . . . . . . . . .       