20
. . . . . . . + + + + + + + + + + . . .
. . . . . . .                   . . . .
. @ . . . . .             . . . . . . .
. . . . . . .             . . . . R . .
. . . . . . .             . . . . . . .
. . . . . . .             . . * . . . .
. . . . . . .             . . . . . . #
. . . * . . . + + + + + + . . . . . . .
. . . . . . .                 . .     +
. . . . . . .                 . .     +
. . . . . . .                 . .     +
. . . . . . .                 . .     +
. . . . . . .                 . . + + +
    . . .                     . .      
    . . .                     . .      
    . F .                     . .      
    . . . + + + + + + + + + + . *      
    . . .                     . .      
    . . .                     . .      
    . $ . . . . . . . . . . . . .       