20
    + + + + + + + + + + + + + + + + + +
. . @                                 +
. . .   + + + + + + + + + + + + +     +
. . .   +                       +     +
. . .   +   + + + + + + + + +   +     +
. . .   +   +               . . . . . .
. $ .   +   +   + + + + +   . . . . . .
. . .   +   +   +   + # +   . . * . . .
. * .   +   +   +   + + +   . . . . . .
R . .   +   +   +           . . . . . .
. . .   . . .   +           +   +     +
. . .   . * .   + + + + + + +   +     +
. . .   . . .                   +     +
. . .   +   + + + + + + + + + + +     +
. . .   +                             +
. E .   + + + + + + + + + + + + + + + +
. . .                                  
. . .                                  
. . .                                  
. . .                                   