20
    + + + + + + + + + + + + + + + + + +
. . @                                 +
. . .   + + + + + + + + + + + + +     +
. . .   +                       +     +
. . .   +   + + + + + + + + +   +     +
. . .   +   +               . . . . . .
. . .   +   +   + + + + +   . . . . . .
. . .   +   +   +   + # +   . . * . . .
. * .   +   +   +   + + +   . . . . . .
. . .   +   +   +           . . . . . .
. . .   . . .   +           +   +     +
. . .   . * .   + + + + + + +   +     +
. . .   . . .                   +     +
. . .   +   + + + + + + + + + + +     +
. . .   +                             +
. M .   + + + + + + + + + + + + + + + +
. . .                                  
. . .                                  
. . .                                  
. . .                                   