20
        . . . . . . . . . . . . . @ . .
    + + . . . . . . * . . . . . . . . .
    +   . . . . . . . . . . . . . . . .
    +             +                   +
. . . . . . F     + + +               +
. . . . . . .         +               +
. . . . . . .         $               +
. . * . . . .         +               +
. . . . . . .         +               +
. . . . . . . + + + + +               +
. . . . . . .                         +
. . . . . . . + + + + + + + + + + + + +
        . . .                          
    + + . . . . . . * . . . . . . . . .
    +   . . . . . . . . . . . . . . . #
    +             +                   +
. . . . . . E     + + +               +
. . . . . . .         +               +
. . . . . . .         +               +
. . * . . . .         +               + 